999939999
911161119
914444419
914444419
204474419
914444419
914444419
911111119
999999999
000009999
011101119
017444419
014444419
004444A63
914444419
91444A419
911101119
999929999
990009399
910101619
91A481A19
917441419
214441419
011111419
004444419
911111119
999999999
999999999
9141414A9
944444449
914111119
914100003
944101119
941101749
9444614A9
999929999
999930000
911111110
917444410
911411410
911411410
911411810
911411110
200444460
999999999
999999999
94A111479
944111489
944111449
941131149
944101449
944101449
9446014A9
992999999