999939999
911161119
914444419
914444419
284474419
914444419
914444419
911111119
999999999
999939999
911161119
914444419
914444419
284474419
914444419
914444419
911111119
999999999
999939999
911161119
914444419
914444419
284474419
914444419
914444419
911111119
999999999
999939999
911161119
914444419
914444419
284474419
914444419
914444419
911111119
999999999
999939999
911161119
914444419
914444419
284474419
914444419
914444419
911111119
999999999
999939999
911161119
914444419
914444419
284474419
914444419
914444419
911111119
999999999