999939999
911100119
911116119
911444119
201444119
900444119
911111119
911111119
999999999
999999999
911111119
911111119
911444609
911444103
911444119
911110119
911100119
999929999
999939999
911101119
911161119
911444119
200474119
911444119
911111119
911111119
999999999
999999999
911111119
911111119
911474119
911447603
911444119
911110119
911100119
999929999
999939999
911100119
911116119
900444119
201444119
911844119
911111119
911111119
999999999
999999999
911111119
91A144419
914161419
914131419
914111419
914441A19
911101119
999929999