0000000000
0111001110
0111001110
0110000110
3000000000
0000000000
0110000110
0111001110
0111001110
0000000000
0000000000
0111001110
0111001110
0110000110
3000000000
0000000000
0110000110
0111001110
0111001110
0000000000
0000000000
0111001110
0111001110
0110000110
3000000000
0000000000
0110000110
0111001110
0111001110
0000000000
0000000000
0111001110
0111001110
0110000110
3000000000
0000000000
0110000110
0111001110
0111001110
0000000000
0000000000
0111001110
0111001110
0110000110
3000000000
0000000000
0110000110
0111001110
0111001110
0000000000
0000000000
0111001110
0111001110
0110000110
3000000000
0000000000
0110000110
0111001110
0111001110
0000000000