0000000000
0222222220
0222222220
0220220220
0220220220
0222222220
0202222020
0200000020
0222222220
0000000000
0000000000
0222222220
0222222220
0220220220
0220220220
0222222220
0202222020
0200000020
0222222220
0000000000
0000000000
0222222220
0222222220
0220220220
0220220220
0222222220
0202222020
0200000020
0222222220
0000000000
0000000000
0222222220
0222222220
0220220220
0220220220
0222222220
0202222020
0200000020
0222222220
0000000000
0000000000
0222222220
0222222220
0220220220
0220220220
0222222220
0202222020
0200000020
0222222220
0000000000
0000000000
0222222220
0222222220
0220220220
0220220220
0222222220
0202222020
0200000020
0222222220
0000000000